####################
##.................#
##.....###########.#
##.....###.....###.#
##########.###.###.#
##.....###.###.###.#
##.###.###.###.###.#
##.###.###.###.###.#
##.........###.....#
####################